############################
#............##............#
#.####.#####.##.#####.####.#
#.#  #.#   #.##.#   #.#  #.#
#.####.#####.##.#####.####.#
#..........................#
############################